 
NO assets/textures/NO.xpm
SO assets/textures/SO.xpm
EA assets/textures/EA.xpm
WE assets/textures/WE.xpm

F 255,127,64
C 0,1,255





     101
     111
  111111111111
  10000000W001
  100000000001
  111111111111




